
F       138, 138, 138
C     56, 56, 56

S ./textures/barrel.XPM   

NO         ./textures/greystone.XPM

SO        ./textures/redbrick.XPM   
WE       ./textures/colorstone.XPM   

EA        ./textures/eagle.XPM   
R 1280  720   


111111111111
102020202011
100000000001
102020202001
100000000001
1020202020N1
111111111111
